NO ./textures/north.xpm
SO ./textures/south.xpm
WE ./textures/west.xpm
EA ./textures/east.xpm

F 220,100,0
C 225,30,0

    111111111111
    100000000001
    101100000001
11111100000000001
10000000011111111
1000000N01 0000011
1111111111111111111