NO ./textures/north.xpm
SO ./textures/south.xpm
WE ./textures/west.xpm
EA ./textures/east.xpm

F 100,100,100
C 50,50,255

   111111
111100001111
100000000001
100001000001
10000S000001
111111111111