NO ./textures/north.xpm
SO ./textures/south.xpm
WE ./textures/west.xpm
EA ./textures/east.xpm

F 120,120,120
C 80,80,255

111111111111111111
100000000000000001
101111111111110101
100000000000010001
100011111110010001
100010000010010001
1000100N0010000001
100011111111111101
100000001 10000001
111111111111111111