NO ./textures/north.xpm
SO ./textures/south.xpm
WE ./textures/west.xpm
EA ./textures/east.xpm

F 150,150,150
C 100,100,100

1111111111111111111111111111111111
1000000000000000000000000000000001
1011111111111100000111111111111101
1010000000000100000100000000000101
1010000000000100000100000000000101
1010000000000100000100000000000101
10100N0000001000001000000E0000101
1010000000000100000100000000000101
1010000000000100000100000000000101
1010000000000100000100000000000101
1011111111111100000111111111111101
1000000000000000000000000000000001
1111111111111111111111111111111111