NO ./textures/north.xpm
SO ./textures/south.xpm
WE ./textures/west.xpm
EA ./textures/east.xpm

F 50,100,150
C 10,10,10

111111111111
100000000001
100W0000001
100000000001
111111111111