NO ./textures/north.xpm
SO ./textures/south.xpm
WE ./textures/west.xpm
EA ./textures/east.xpm

F 150,150,150
C 100,100,100

1111111
1000001
100N001
1111111