NO ./textures/north.xpm
SO ./textures/south.xpm
WE ./textures/west.xpm
EA ./textures/east.xpm

F 0,0,0
C 255,255,255

1111111111111111
1     0000000001
1 0000000000001
1 000E00000001
1 0000000000001
1111111111111111